Philippines	diplomatic relation	Greece
Gretchen Wilson	field of work	musical composition
Liberia	diplomatic relation	People's Republic of China
Philip Roth	occupation	science fiction writer
People's Republic of China	diplomatic relation	Belgium
Joumana Haddad	occupation	translator
Tupac Shakur	residence	Manhattan
John Maynard Keynes	occupation	non-fiction writer
United States of America	diplomatic relation	Holy See
Albania	diplomatic relation	Serbia
Australia	member of	Organisation for the Prohibition of Chemical Weapons
Max Frisch	occupation	biographer
Václav Havel	languages spoken, written, or signed	Czech
Liberia	member of	UNESCO
Albert Einstein	country of citizenship	German Empire
Israel	diplomatic relation	Switzerland
Argentina	diplomatic relation	Qatar
Salman Rushdie	languages spoken, written, or signed	English
Angola	member of	"African, Caribbean and Pacific Group of States"
Richard Francis Burton	occupation	explorer
Julie Delpy	occupation	television actor
Brian Molko	occupation	songwriter
Dannii Minogue	record label	Universal Music Group
Sudan	member of	Organisation of Islamic Cooperation
Australia	diplomatic relation	Norway
Jay Chou	genre	pop music
Malaysia	diplomatic relation	Maldives
Myanmar	diplomatic relation	Philippines
Wilhelm Ostwald	member of	Royal Netherlands Academy of Arts and Sciences
Lev Gumilyov	occupation	philosopher
France	diplomatic relation	Brazil
United Kingdom	member of	European Union
Mel Gibson	country of citizenship	United States of America
Yo-Yo Ma	occupation	actor
Pierre-Simon Laplace	occupation	university teacher
Anatoly Lunacharsky	languages spoken, written, or signed	Russian
Hayley Williams	instrument	piano
David Bowie	movement	new wave
Frédéric Chopin	languages spoken, written, or signed	French
Steve Carell	occupation	voice actor
People's Republic of China	diplomatic relation	Morocco
Nora Ephron	occupation	essayist
Saudi Arabia	diplomatic relation	Turkmenistan
John Cale	occupation	composer
Masiela Lusha	occupation	television actor
Kingdom of the Netherlands	member of	International Bank for Reconstruction and Development
J. K. Rowling	occupation	screenwriter
Lisa Marie Presley	record label	Capitol Records
Tyler, the Creator	occupation	songwriter
United Kingdom	diplomatic relation	Cuba
Jean-Antoine-Nicolas de Caritat de Condorcet	religion	atheism
Joseph Louis Gay-Lussac	member of	Société Philomathique de Paris
Edward Said	country of citizenship	United States of America
Sebastian Haffner	occupation	jurist
Jerry Lewis	ethnic group	American Jews
Yeshayahu Leibowitz	occupation	journalist
Mick Jagger	record label	Universal Music Group
Czech Republic	member of	World Trade Organization
Sergey Mikhalkov	languages spoken, written, or signed	Russian
Jean-Paul Sartre	occupation	playwright
Slavoj Žižek	influenced by	Fredric Jameson
Henry Kissinger	occupation	autobiographer
Franz Kafka	occupation	short story writer
Guatemala	part of	Hispanic America
Friedrich Nietzsche	influenced by	Georg Christoph Lichtenberg
Debbie Harry	genre	new wave
Suzi Quatro	instrument	voice
Poland	diplomatic relation	Latvia
Alexander Emanuel Agassiz	occupation	engineer
Berry Gordy	occupation	film producer
Brad Delson	genre	traditional heavy metal
United Kingdom	diplomatic relation	Azerbaijan
Mark Salling	occupation	television actor
Charles Dickens	occupation	children's writer
Burundi	member of	Universal Postal Union
Harry Connick Jr.	genre	jazz
Marietta Shaginyan	place of birth	Moscow
Armenia	diplomatic relation	Kosovo
Andrew Ridgeley	occupation	singer
Robert Louis Stevenson	occupation	short story writer
Zooey Deschanel	occupation	singer
India	diplomatic relation	Ivory Coast
Camille Saint-Saëns	genre	opera
Chord Overstreet	occupation	actor
Peru	diplomatic relation	Australia
Jill Scott	languages spoken, written, or signed	English
Cuba	member of	Interpol
George Harrison	occupation	songwriter
Milla Jovovich	country of citizenship	Ukraine
Dr. Dre	instrument	synthesizer
Gustav Kirchhoff	member of	Russian Academy of Sciences
Philippines	member of	United Nations
Moldova	member of	International Centre for Settlement of Investment Disputes
Miguel	country of citizenship	United States of America
Van Morrison	instrument	guitar
Roy Orbison	country of citizenship	United States of America
Serge Gainsbourg	occupation	painter
Taiwan	diplomatic relation	Cape Verde
Hugo Grotius	occupation	philosopher
Laurie Anderson	instrument	voice
Nikolai Gogol	place of death	Moscow
Ivan Yefremov	country of citizenship	Soviet Union
Ludwig Prandtl	member of	Royal Society
Jack Black	languages spoken, written, or signed	English
Mikhail Zadornov	occupation	writer
Namibia	diplomatic relation	North Korea
Atlantic Records	country	United States of America
Albert Szent-Györgyi	instrument	piano
Peter Ustinov	languages spoken, written, or signed	German
Alexander Bogdanov	place of burial	Novodevichy Cemetery
Mary Shelley	occupation	biographer
Paul Dirac	member of	Pontifical Academy of Sciences
David Foster	country of citizenship	Canada
Russia	member of	Nuclear Suppliers Group
Brian Molko	genre	rock music
Lenny Kravitz	languages spoken, written, or signed	English
Alberto Manguel	occupation	author
Togo	diplomatic relation	Germany
United Kingdom	diplomatic relation	South Africa
André-Marie Ampère	occupation	mathematician
Indonesia	diplomatic relation	Sri Lanka
Ian McLagan	occupation	composer
Carl Orff	member of	Bavarian Academy of Fine Arts
Myanmar	diplomatic relation	People's Republic of China
Mary Wollstonecraft	languages spoken, written, or signed	French
Ingmar Bergman	occupation	playwright
Melissa Auf der Maur	field of work	musical composition
Melchior de Vogüé	employer	Saint Petersburg Academy of Sciences
United States of America	diplomatic relation	Bolivia
Anatole Abragam	occupation	university teacher
United States of America	diplomatic relation	Uzbekistan
Papua New Guinea	member of	Alliance of Small Island States;
Shakira	influenced by	John Lennon
New Zealand	official language	English
Japan	diplomatic relation	Greece
Tyler, the Creator	record label	Columbia Records
Mario Vargas Llosa	occupation	literary critic
Lewis Carroll	occupation	mathematician
Aaron Copland	place of death	New York City
Ginger Rogers	occupation	singer
Darius Milhaud	languages spoken, written, or signed	French
Steven Seagal	occupation	screenwriter
Urbain Le Verrier	educated at	École Polytechnique
Seth Rogen	occupation	actor
Akiko Yano	genre	soul music
Thomas Mann	religion	Lutheranism
John Turturro	occupation	character actor
Victoria Beckham	genre	contemporary R&B
Robert De Niro	member of political party	Democratic Party
David Crosby	occupation	guitarist
Marlon Jackson	record label	Epic
Thomas Anders	country of citizenship	Germany
Kris Kristofferson	occupation	singer
Elizabeth Bishop	occupation	writer
T-Bone Walker	occupation	musician
Tony Visconti	instrument	voice
Kazakhstan	diplomatic relation	Iran
Thailand	diplomatic relation	Singapore
Jackson Browne	instrument	voice
Japan	member of	Asia-Pacific Economic Cooperation
Larry David	ethnic group	American Jews
Alfred Einstein	occupation	musicologist
The Edge	occupation	banjoist
Jacob Grimm	sibling	Wilhelm Grimm
Kevin Costner	occupation	film director
Billy Preston	occupation	pianist
Romania	diplomatic relation	Mexico
Thomas Jefferson	languages spoken, written, or signed	French
George Eliot	religion	agnosticism
Mexico	diplomatic relation	Nicaragua
Vladimir Putin	occupation	autobiographer
John Legend	genre	rhythm and blues
Finland	diplomatic relation	Denmark
Friedrich Nietzsche	influenced by	Johann Wolfgang von Goethe
Reprise Records	parent organization	Warner Music Group
Lena Horne	genre	traditional pop music
Glukoza	genre	synth-pop
Brazil	diplomatic relation	Argentina
Simon Newcomb	member of	Royal Netherlands Academy of Arts and Sciences
United Kingdom	diplomatic relation	Egypt
Vladimir Prelog	member of	National Academy of Sciences
Yemen	diplomatic relation	Georgia
Georgia	diplomatic relation	Zambia
Jimmy Buffett	occupation	entrepreneur
Switzerland	diplomatic relation	Philippines
Stephen Hawking	occupation	autobiographer
Mikhail Zadornov	occupation	engineer
Serbia	diplomatic relation	Uzbekistan
Republic of Cyprus	diplomatic relation	United Kingdom
Eritrea	diplomatic relation	Denmark
Chuck Berry	occupation	recording artist
Czesław Miłosz	employer	"University of California, Berkeley"
W. H. Auden	languages spoken, written, or signed	English
Lenny Kravitz	instrument	percussion instrument
Gene Kelly	occupation	film producer
Emma Bunton	instrument	voice
Telly Savalas	instrument	voice
Bud Spencer	occupation	film director
Jemaine Clement	occupation	singer
Snoop Dogg	genre	funk
Aaron Copland	occupation	choreographer
Joseph Heller	occupation	playwright
André Gide	occupation	author
Paul Simon	occupation	musician
Christina Milian	country of citizenship	United States of America
Idina Menzel	occupation	writer
Romain Rolland	member of	Academy of Sciences of the USSR
David Attenborough	occupation	film director
Paul Valéry	occupation	philosopher
Alexis Korner	occupation	musician
Elmer Bernstein	occupation	conductor
Turkey	member of	Nuclear Suppliers Group
Donny Osmond	occupation	stage actor
Big Boi	genre	hip hop music
United Kingdom	diplomatic relation	Papua New Guinea
Nelly Furtado	instrument	piano
Philip Warren Anderson	member of	Royal Society
Fazil Iskander	genre	prose
Mel Gibson	religion	Catholic Church
Linda Ronstadt	record label	Capitol Records
Alan Stivell	occupation	composer
František Palacký	languages spoken, written, or signed	Czech
South Africa	diplomatic relation	Namibia
Kosovo	diplomatic relation	Finland
Lara Fabian	languages spoken, written, or signed	English
Luciano Berio	languages spoken, written, or signed	Italian
Henri Victor Regnault	member of	Hungarian Academy of Sciences;
Nikolai Fomenko	occupation	film producer
Rebbie Jackson	genre	soul music
Henry James	member of	Phi Beta Kappa Society
Ben Elton	occupation	author
Senegal	part of	West Africa
Pyotr Ilyich Tchaikovsky	occupation	conductor
Pakistan	diplomatic relation	Chile
Peggy Lee	occupation	singer
Jérôme Lalande	occupation	professor
Harold Bloom	employer	New York University
Poland	member of	Council of Europe
Saudi Arabia	diplomatic relation	Kenya
Romania	diplomatic relation	State of Palestine
Ralf Dahrendorf	country of citizenship	Germany
Mercury Records	parent organization	Universal Music Group
Joseph Heller	occupation	screenwriter
Lionel Hampton	ethnic group	African Americans
Antoine César Becquerel	member of	Royal Prussian Academy of Sciences
Singapore	member of	International Centre for Settlement of Investment Disputes
Johann Wolfgang von Goethe	occupation	librettist
People's Republic of China	diplomatic relation	Tajikistan
David Byrne	occupation	record producer
Donovan	record label	Epic
Afrika Bambaataa	ethnic group	African Americans
Germany	diplomatic relation	Nicaragua
Jacobus Henricus van 't Hoff	member of	Academy of Sciences of Turin;
Gerald Wilson	genre	jazz
Charles Babbage	occupation	mathematician
Falco	instrument	voice
Jackson Browne	genre	rock music
Melissa Auf der Maur	occupation	blogger
Panama	member of	International Development Association
Kevin Spacey	occupation	film director
GoonRock	occupation	songwriter
Harald Weinrich	languages spoken, written, or signed	Spanish
Moldova	diplomatic relation	Taiwan
William Thomson, 1st Baron Kelvin	member of	Bavarian Academy of Sciences and Humanities
Kenny Rogers	genre	rock music
Yuri Shevchuk	occupation	singer-songwriter
Angie Stone	ethnic group	African Americans
Greece	diplomatic relation	Norway
Nicholas Marr	employer	Saint Petersburg State University
Victor Ambartsumian	occupation	astronomer
Vladimir Lenin	languages spoken, written, or signed	Russian
Harry Connick Jr.	occupation	pianist
David Bowie	occupation	painter
Kenny Rogers	instrument	bass guitar
Dido	genre	contemporary folk music
Cuba	diplomatic relation	Sri Lanka
Netherlands	diplomatic relation	Belarus
Lisa Lopes	record label	Arista
Charles Wheatstone	member of	American Academy of Arts and Sciences
A. R. Rahman	instrument	keyboard instrument
T-Bone Walker	occupation	street artist
Kwame Anthony Appiah	influenced by	Georg Wilhelm Friedrich Hegel
Jon Bon Jovi	occupation	actor
Brendon Urie	religion	atheism
Billy Bob Thornton	occupation	singer
Alice Cooper	instrument	harmonica
Edward Said	languages spoken, written, or signed	English
Charles Baudelaire	influenced by	Edgar Allan Poe
Comoros	member of	Alliance of Small Island States;
Sergey Mikhalkov	occupation	translator
Randy Newman	record label	Warner Bros. Records
Milan Kundera	country of citizenship	Czech Republic
Germany	diplomatic relation	Mexico
Czechoslovakia	diplomatic relation	Norway
Henri Poincaré	member of	American Academy of Arts and Sciences
Kanye West	languages spoken, written, or signed	English
Felix Klein	place of death	Göttingen
Mikhail Zadornov	country of citizenship	Russia
Gabriel Marcel	member of	Bavarian Academy of Fine Arts
Henri Poincaré	member of	Royal Netherlands Academy of Arts and Sciences
Taiwan	diplomatic relation	Jamaica
Albertus Magnus	occupation	philosopher
Hungary	diplomatic relation	Canada
Bertrand Russell	field of work	mathematics
Dmitry Glukhovsky	country of citizenship	Russia
Barbara Mandrell	instrument	guitar
São Tomé and Príncipe	member of	United Nations
Johnny Hallyday	record label	Warner Music Group
Jean-Antoine-Nicolas de Caritat de Condorcet	field of work	mathematics
Sergey Mikhalkov	occupation	songwriter
People's Republic of China	diplomatic relation	Uganda
Snoop Dogg	occupation	businessperson
Paul Jozef Crutzen	member of	Russian Academy of Sciences
Venezuela	diplomatic relation	Uruguay
Bette Midler	occupation	singer
Jared Leto	occupation	producer
Anton Bruckner	instrument	organ
Kinky Friedman	occupation	singer-songwriter
Drake Bell	occupation	actor
Antoine César Becquerel	member of	Accademia Nazionale delle Scienze detta dei XL
Che Guevara	residence	Mexico
David Byrne	occupation	artist
India	diplomatic relation	United Kingdom
Australia	diplomatic relation	European Union
Ethiopia	diplomatic relation	India
Katy Perry	occupation	actor
Nicaragua	member of	International Bank for Reconstruction and Development
Hannes Alfvén	occupation	astronomer
William Styron	influenced by	Albert Camus
Togo	member of	International Centre for Settlement of Investment Disputes
Billy Bob Thornton	occupation	songwriter
Tim Rice-Oxley	occupation	pianist
Mauritius	diplomatic relation	People's Republic of China
Mae West	record label	Decca
Roman Jakobson	country of citizenship	Russian Soviet Federative Socialist Republic
Ben Moody	country of citizenship	United States of America
David Lindley	record label	Warner Bros. Records
Richard Sennett	influenced by	Hannah Arendt
Donny Hathaway	place of death	New York City
Gilbert Bécaud	genre	opera
Yasmina Reza	occupation	author
Paul McCartney	occupation	screenwriter
Idina Menzel	genre	pop music
Clive Barker	influenced by	Edgar Allan Poe
Mary Shelley	spouse	Percy Bysshe Shelley
Oswald Heer	member of	Royal Society
Emmanuel Swedenborg	member of	Royal Swedish Academy of Sciences;
Miguel de Unamuno	occupation	playwright
Greece	diplomatic relation	Sweden
Wole Soyinka	occupation	poet
Thomas Aquinas	influenced by	Avicenna
Buckminster Fuller	occupation	engineer
David Hume	field of work	philosophy
Lev Gumilyov	country of citizenship	Russian Soviet Federative Socialist Republic
Gary Becker	occupation	blogger
Niger	continent	Africa
Canada	diplomatic relation	Azerbaijan
Valery Leontiev	genre	pop music
Heinrich Wilhelm Olbers	member of	Accademia Nazionale delle Scienze detta dei XL
Snoop Dogg	occupation	television actor
Ingmar Bergman	member of	American Academy of Arts and Sciences
William Herschel	member of	Russian Academy of Sciences
Corbin Bleu	place of birth	Brooklyn
Belarus	diplomatic relation	Poland
United Kingdom	member of	Organization for Security and Co-operation in Europe
Lion Feuchtwanger	genre	play
Ice Cube	languages spoken, written, or signed	English
Egypt	continent	Africa
Jonathan Winters	record label	Columbia Records
Henry Wadsworth Longfellow	languages spoken, written, or signed	Italian
Guinea-Bissau	member of	African Development Bank
Sergey Lazarev	instrument	piano
Georgia	diplomatic relation	Cambodia
Chris Martin	record label	Universal Music Group
Debbie Reynolds	occupation	writer
Georgia	diplomatic relation	Brunei
Sudan	member of	United Nations
Lea Salonga	genre	classical music
William Shatner	instrument	voice
Vladimir Nabokov	occupation	poet
Gottfried Wilhelm Leibniz	influenced by	Plato
Wiz Khalifa	residence	Japan
United Arab Emirates	member of	International Telecommunication Union
Harald Weinrich	ethnic group	Germans
Henri Victor Regnault	member of	Royal Prussian Academy of Sciences
Joan Rivers	occupation	voice actor
Angélique Kidjo	occupation	actor
Jean Gaston Darboux	member of	Royal Netherlands Academy of Arts and Sciences
Charlton Heston	country of citizenship	United States of America
Augustine of Hippo	religion	Catholic Church
India	diplomatic relation	Mexico
Lance Bass	occupation	singer
Australia	diplomatic relation	Dominican Republic
Alice Cooper	occupation	musician
Burkina Faso	diplomatic relation	Taiwan
Republic of Cyprus	member of	International Bank for Reconstruction and Development
EMI	location of formation	London
Georgia	diplomatic relation	Bahrain
Daniel Lanois	occupation	singer
Jonathan Swift	occupation	novelist
Melchior de Vogüé	occupation	diplomat
Soviet Union	diplomatic relation	Cuba
Gaspard Monge	member of	Société Philomathique de Paris
Guyana	diplomatic relation	Germany
A. A. Milne	occupation	prosaist
Cameroon	member of	United Nations
RZA	occupation	actor
Guyana	official language	English
Hyde	occupation	singer
Ernst Chladni	member of	Academy of Sciences of Turin;
Gretchen Wilson	occupation	musician
Hector Berlioz	genre	opera
Alphonse Daudet	genre	novel
Zhores Alfyorov	religion	atheism
Jay Chou	genre	hip hop music
Fred Astaire	occupation	singer
Harald Weinrich	languages spoken, written, or signed	English
Rita Lee	genre	pop music
Jerry Reed	occupation	composer
Doris Lessing	occupation	writer
Cher	occupation	singer
Brian Molko	instrument	voice
Billy Connolly	occupation	stage actor
People's Republic of China	diplomatic relation	European Union
Michail Sholokhov	country of citizenship	Russian Empire
Arnold Schwarzenegger	occupation	businessperson
Joseph Priestley	member of	Royal Swedish Academy of Sciences;
Trey Parker	occupation	television actor
Russia	diplomatic relation	Thailand
Teena Marie	languages spoken, written, or signed	English
Morocco	continent	Africa
Henry Rollins	occupation	actor
Nelly	occupation	film producer
Jerry Reed	occupation	film producer
Venezuela	member of	International Telecommunication Union
Gabriel García Márquez	genre	novel
Bob Dylan	occupation	lyricist
Ulf Ekberg	occupation	film producer
Paraguay	diplomatic relation	South Korea
Moritz von Jacobi	occupation	physicist
Australia	diplomatic relation	Brazil
Donny Osmond	occupation	film producer
Marcellin Berthelot	place of birth	Paris
Wernher von Braun	languages spoken, written, or signed	English
Richard Marx	occupation	composer
William S. Burroughs	member of	American Academy of Arts and Letters
Yasmina Reza	country of citizenship	France
Berry Gordy	occupation	musician
Karel Jaromír Erben	occupation	poet
Czesław Miłosz	country of citizenship	United States of America
Hulk Hogan	country of citizenship	United States of America
Osip Mandelstam	influenced by	Mikhail Lermontov
Richard Wagner	country of citizenship	Germany
Sudan	member of	Arab Fund for Economic and Social Development
Gabriel Lamé	employer	École Polytechnique
Miranda Cosgrove	occupation	singer
Brendon Urie	occupation	musician
Senegal	member of	UNESCO
Lea Salonga	instrument	voice
North Macedonia	diplomatic relation	Montenegro
Alexander von Humboldt	member of	Royal Netherlands Academy of Arts and Sciences
Rwanda	member of	United Nations
Mauritius	member of	UNESCO
Leó Szilárd	occupation	university teacher
Nelly Furtado	instrument	voice
Lord Byron	occupation	playwright
Kyrgyzstan	diplomatic relation	Malaysia
Bill Cosby	occupation	television actor
Jan Hammer	occupation	musician
George Eliot	ethnic group	English people
Sudan	official language	Arabic
Malaysia	member of	UNESCO
Stephen Jay Gould	employer	New York University
Vanuatu	diplomatic relation	France
Walter Benjamin	influenced by	György Lukács
Germany	diplomatic relation	Niger
Theodor W. Adorno	occupation	university teacher
Turkey	diplomatic relation	Bangladesh
Qatar	member of	Interpol
Joe Jackson	occupation	record producer
Douglas Adams	occupation	children's writer
Konstantin Eduardovich Tsiolkovskii	occupation	science fiction writer
Taiwan	diplomatic relation	Tajikistan
Lloyd Price	languages spoken, written, or signed	English
J. Rodolfo Wilcock	country of citizenship	Kingdom of Italy
Hungary	diplomatic relation	Turkey
Tina Arena	occupation	screenwriter
Shannon Leto	occupation	musician
Seychelles	member of	United Nations
Lori Lieberman	genre	pop music
Katerina Graham	genre	contemporary R&B
Joseph Priestley	field of work	philosophy
Ethiopia	diplomatic relation	Finland
Adam Sandler	country of citizenship	United States of America
Ralph Waldo Emerson	occupation	essayist
Switzerland	member of	Group on Earth Observations
Dannii Minogue	genre	disco
Konrad Lorenz	member of	American Academy of Arts and Sciences
Myles Kennedy	instrument	bass guitar
Ilya Ehrenburg	languages spoken, written, or signed	Russian
Taiwan	diplomatic relation	Uruguay
Tunisia	continent	Africa
James Bryant Conant	occupation	teacher
Ricky Nelson	occupation	singer
Isaac Hayes	occupation	television actor
David Bowie	movement	art rock
Tinashe	country of citizenship	United States of America
Avicii	record label	Island Records
Rita Levi-Montalcini	country of citizenship	United States of America
James Blake	occupation	composer
Hayley Williams	occupation	entrepreneur
Trinidad and Tobago	member of	International Development Association
Ferdinand von Richthofen	member of	Royal Prussian Academy of Sciences
Bosnia and Herzegovina	diplomatic relation	Montenegro
Taiwan	diplomatic relation	Jordan
Sarah Silverman	occupation	voice actor
Pakistan	diplomatic relation	Yemen
Belgium	member of	Nuclear Suppliers Group
Armenia	member of	Organisation internationale de la Francophonie
Lana Del Rey	occupation	recording artist
South Korea	diplomatic relation	Saudi Arabia
Steven Tyler	record label	Columbia Records
Karl Mannheim	occupation	writer
Bobby Darin	genre	pop rock
Senegal	diplomatic relation	Bangladesh
Peter Debye	member of	Bavarian Academy of Sciences and Humanities
Myles Kennedy	occupation	singer
Ethiopia	diplomatic relation	Zambia
Lisa Marie Presley	occupation	film actor
Method Man	genre	hip hop music
Ecuador	member of	Agency for the Prohibition of Nuclear Weapons in Latin America and the Caribbean
Sebastian Haffner	place of death	Berlin
Trent Reznor	instrument	synthesizer
Vladimir Obruchev	country of citizenship	Soviet Union
John Paul II	occupation	philosopher
Miley Cyrus	occupation	voice actor
Trinidad and Tobago	continent	North America
John Cage	genre	electronic music
Alan Arkin	occupation	singer
Jacob Grimm	country of citizenship	Germany
James Taylor	occupation	guitarist
Natalie Cole	field of work	musical composition
Albrecht von Haller	occupation	university teacher
Ukraine	diplomatic relation	Mexico
Lara Fabian	record label	Polydor Records
André-Marie Ampère	occupation	philosopher
John Bardeen	member of	Academy of Sciences of the USSR
Billy Preston	genre	gospel music
Heinrich Schliemann	languages spoken, written, or signed	German
Tajikistan	diplomatic relation	Afghanistan
Beth Hart	genre	soul music
South Korea	diplomatic relation	Brazil
Angie Stone	country of citizenship	United States of America
Walker Percy	member of	American Academy of Arts and Sciences
Theodor W. Adorno	occupation	musicologist
Gilles Deleuze	occupation	university teacher
Denmark	diplomatic relation	Pakistan
David Cross	instrument	voice
Indonesia	member of	International Development Association
Paul Jozef Crutzen	member of	National Academy of Sciences
Guy de Maupassant	influenced by	Honoré de Balzac
Uruguay	diplomatic relation	Brazil
Justin Bieber	languages spoken, written, or signed	English
United States of America	continent	Oceania
Gary Becker	occupation	professor
Svetlana Surganova	genre	jazz
Samuel P. Huntington	occupation	sociologist
Saudi Arabia	member of	Organisation for the Prohibition of Chemical Weapons
Glukoza	occupation	voice actor
Kate Bush	genre	alternative rock
Kurt Vonnegut	member of	American Academy of Arts and Sciences
Heinrich Brunner	languages spoken, written, or signed	German
Tunisia	member of	UNESCO
Malaysia	member of	Group on Earth Observations
Fergie	occupation	voice actor
Sergey Mikhalkov	member of political party	Communist Party of the Soviet Union
Hilary Duff	occupation	businessperson
Oscar Wilde	occupation	journalist
Joni Mitchell	occupation	musician
Ludacris	genre	hip hop music
Brazil	diplomatic relation	Germany
Turkey	member of	African Union – United Nations Hybrid Operation in Darfur
Philip Warren Anderson	member of	National Academy of Sciences
Erykah Badu	occupation	composer
Sofia Kovalevskaya	educated at	University of Göttingen
Hungary	diplomatic relation	Malta
Jonathan Winters	occupation	writer
Nas	occupation	actor
Mikhail Bulgakov	occupation	writer
Ed Sheeran	record label	Atlantic Records
Lauren Bacall	place of death	Manhattan
Hungary	member of	Movement Coordination Centre Europe
Dominican Republic	member of	Organisation internationale de la Francophonie
E. T. A. Hoffmann	occupation	novelist
Tito Jackson	sibling	Janet Jackson
John de Lancie	occupation	voice actor
Omar Sharif	occupation	non-fiction writer
Cher	occupation	model
André Malraux	occupation	novelist
Urbain Le Verrier	member of	American Academy of Arts and Sciences
Barbados	diplomatic relation	Guyana
Eritrea	diplomatic relation	Germany
Karl Popper	country of citizenship	United Kingdom of Great Britain and Ireland
Jim Messina	instrument	mandolin
Ludwig Prandtl	employer	University of Göttingen
Walter Benjamin	influenced by	Karl Marx
Frank Zappa	record label	Warner Bros. Records
Luxembourg	official language	German
František Palacký	employer	Saint Petersburg Academy of Sciences
Yo-Yo Ma	record label	Columbia Records
Graham Greene	occupation	autobiographer
Seth Rogen	country of citizenship	Canada
Avril Lavigne	country of citizenship	Canada
Angola	member of	African Union
Helge Schneider	occupation	author
Leonard Cohen	occupation	musician
Serbia	diplomatic relation	Belarus
Sierra Leone	member of	"African, Caribbean and Pacific Group of States"
Djibouti	member of	African Union – United Nations Hybrid Operation in Darfur
Tunisia	diplomatic relation	Russia
Saudi Arabia	diplomatic relation	Romania
John Hartford	place of birth	New York City
Brazil	member of	Organization of American States
Kingdom of the Netherlands	member of	European Union
Mariah Carey	record label	Island Records
Jerry Garcia	occupation	composer
George Eliot	movement	literary realism
Kelly Clarkson	languages spoken, written, or signed	English
Ukraine	diplomatic relation	Bulgaria
Czechoslovakia	diplomatic relation	Soviet Union
Belize	member of	"African, Caribbean and Pacific Group of States"
Laos	diplomatic relation	India
Guyana	member of	"African, Caribbean and Pacific Group of States"
Bing Crosby	occupation	film actor
Tupac Shakur	ethnic group	African Americans
Australia	diplomatic relation	Pakistan
Iran	diplomatic relation	Yemen
Taiwan	diplomatic relation	Switzerland
Sarah McLachlan	occupation	singer-songwriter
Snoop Dogg	genre	contemporary R&B
Cuba	diplomatic relation	Kiribati
Italy	member of	Visa Waiver Program
Hannah Arendt	influenced by	Plato
Jaden Smith	occupation	television actor
Nyusha	country of citizenship	Russia
John Milton	languages spoken, written, or signed	Hebrew
Ross Bagdasarian Sr.	genre	pop music
Italy	member of	Treaty on Open Skies;
Bangladesh	diplomatic relation	Georgia
Finland	diplomatic relation	Iran
Libya	diplomatic relation	France
Leonid Leonov	place of birth	Moscow
Sri Lanka	diplomatic relation	United States of America
Jennifer Love Hewitt	religion	Catholic Church
Germany	diplomatic relation	Bosnia and Herzegovina
Bo Burnham	instrument	guitar
Stephen Jay Gould	occupation	philosopher
Alexander Pushkin	occupation	playwright
Uruguay	part of	Latin America
Iceland	member of	UNESCO
Yo-Yo Ma	country of citizenship	People's Republic of China
Guinea-Bissau	diplomatic relation	United States of America
Václav Havel	religion	Catholicism
Billy Joel	place of birth	New York City
Hugo Huppert	languages spoken, written, or signed	German
Russell Brand	country of citizenship	United Kingdom
Karlheinz Stockhausen	instrument	violin
France	diplomatic relation	Romania
Gilles Deleuze	occupation	philosopher
Eugène Ionesco	place of burial	Montparnasse Cemetery
Arthur Miller	occupation	playwright
Frank Zappa	occupation	guitarist
France	diplomatic relation	Singapore
Panama	member of	Agency for the Prohibition of Nuclear Weapons in Latin America and the Caribbean
Taylor Swift	occupation	television actor
Pakistan	member of	Multilateral Investment Guarantee Agency;
Madonna	occupation	producer
Douglas Adams	occupation	screenwriter
Shakira	employer	Epic
Honduras	official language	Spanish
Wilhelm Blaschke	occupation	university teacher
Canada	member of	Treaty on Open Skies;
François Guizot	member of	Bavarian Academy of Sciences and Humanities
Poland	member of	Universal Postal Union
Heinrich Rudolf Hertz	occupation	university teacher
Lou Reed	occupation	songwriter
Joan Baez	instrument	guitar
Stephen Jay Gould	educated at	Columbia University
Sweden	member of	International Energy Agency
Jack Black	occupation	screenwriter
Cat Stevens	record label	Island Records
Israel	diplomatic relation	Sweden
Israel	diplomatic relation	Malawi
Asia Argento	occupation	television presenter
Jodie Foster	occupation	film actor
Diana Arbenina	instrument	piano
Jamaica	member of	Universal Postal Union
Pyotr Ilyich Tchaikovsky	occupation	pedagogue
Jean-Baptiste Biot	member of	American Academy of Arts and Sciences
Tracy Chapman	instrument	guitar
Michael Jackson	occupation	choreographer
Malta	member of	International Bank for Reconstruction and Development
Richard Dawkins	influenced by	Bertrand Russell
Jared Leto	occupation	painter
Woodrow Wilson	occupation	politician
Marcellin Berthelot	member of	American Academy of Arts and Sciences
Urbain Le Verrier	ethnic group	French people
John Maynard Keynes	employer	University of Cambridge
Hugo Huppert	occupation	prosaist
El Salvador	member of	Universal Postal Union
Netherlands	member of	Organization for Security and Co-operation in Europe
Stanisław Lem	cause of death	heart failure
Herbie Hancock	country of citizenship	United States of America
Cuba	diplomatic relation	South Africa
Romain Gary	occupation	politician
Peter Handke	occupation	film director
Miguel de Unamuno	occupation	novelist
James Joyce	instrument	voice
Tatyana Tolstaya	country of citizenship	Soviet Union
Marilyn Manson	instrument	saxophone
Miley Cyrus	record label	Hollywood Records
Rick Rubin	record label	Def Jam Recordings
Arthur C. Clarke	residence	Sri Lanka
Woody Guthrie	occupation	singer
Hugh Laurie	occupation	television director
Ethiopia	diplomatic relation	Hungary
David Clayton-Thomas	occupation	guitarist
Emma Goldman	languages spoken, written, or signed	Russian
Giuseppe Ungaretti	country of citizenship	Italy
T-Bone Walker	record label	Capitol Records
Missy Elliott	genre	hip hop music
A. R. Rahman	occupation	entrepreneur
South Korea	diplomatic relation	Thailand
Ben Elton	occupation	songwriter
Iraq	diplomatic relation	Egypt
Somalia	diplomatic relation	Turkey
Karl Valentin	country of citizenship	Germany
Eduard Limonov	place of death	Moscow
Nicki Minaj	genre	synth-pop
Alejandro Jodorowsky	occupation	theater director
Geddy Lee	instrument	voice
John Milton	occupation	writer
South Korea	diplomatic relation	Germany
Paul G. Allen	instrument	guitar
John Cage	member of	American Academy of Arts and Letters
Tomáš Garrigue Masaryk	educated at	University of Vienna
Hungary	diplomatic relation	Vietnam
Indonesia	diplomatic relation	Tanzania
Kurt Weill	ethnic group	Germans
Kris Kristofferson	instrument	voice
Gotthelf Fischer von Waldheim	occupation	zoologist
MC Hammer	occupation	film score composer
Ernst Mach	employer	University of Vienna
Samuel R. Delany	influenced by	Jacques Derrida
Ethiopia	diplomatic relation	Malaysia
John Hartford	occupation	mandolinist
June Carter Cash	occupation	singer-songwriter
Lonnie Liston Smith	occupation	jazz musician
Melanie Brown	occupation	actor
Chile	diplomatic relation	Italy
Aram Khachaturian	occupation	choreographer
Israel	diplomatic relation	Philippines
Japan	diplomatic relation	Australia
Mario Vargas Llosa	occupation	screenwriter
Tila Tequila	occupation	fashion designer
Brazil	diplomatic relation	Venezuela
Donovan	occupation	guitarist
Bangladesh	diplomatic relation	Kyrgyzstan
Anton Chekhov	influenced by	Ivan Turgenev
Saint Petersburg Academy of Sciences	country	Russia
Erich Kästner	country of citizenship	West Germany
Stephen Spender	occupation	translator
Joan Jett	record label	MCA Records
Ivan Franko	occupation	economist
Johann Christian Poggendorff	ethnic group	Germans
John Cale	instrument	keyboard instrument
Laurie Anderson	occupation	musician
Aleksey Nikolayevich Tolstoy	occupation	screenwriter
Gloria Trevi	occupation	dancer
Steve Carell	occupation	comedian
Sergey Mikhalkov	country of citizenship	Russian Empire
Phil Harris	occupation	conductor
Willie Nelson	record label	Atlantic Records
Joan Rivers	occupation	journalist
Uruguay	diplomatic relation	Paraguay
Malta	diplomatic relation	Italy
Tanzania	member of	Multilateral Investment Guarantee Agency;
Anatole Abragam	occupation	engineer
East Timor	diplomatic relation	Japan
Cher	instrument	voice
Afghanistan	member of	Organisation for the Prohibition of Chemical Weapons
Eugen Rosenstock-Huessy	place of birth	Berlin
Chinghiz Aitmatov	member of political party	Communist Party of the Soviet Union
Danny Glover	occupation	singer
Vitaly Ginzburg	member of political party	Communist Party of the Soviet Union
Israel	official language	Hebrew
Steve Martin	instrument	banjo
Henrik Steffens	country of citizenship	Norway
Japan	diplomatic relation	Israel
Yevgeny Yevtushenko	genre	prose
Friedrich Carl von Savigny	occupation	jurist
Syd Barrett	occupation	songwriter
Robert McNamara	languages spoken, written, or signed	English
Harold Bloom	employer	Yale University
Estonia	diplomatic relation	Georgia
Joaquim Maria Machado de Assis	occupation	writer
Andrea Bocelli	languages spoken, written, or signed	Portuguese
Rob Reiner	country of citizenship	United States of America
Katharine McPhee	occupation	singer
Serge Gainsbourg	occupation	pianist
Isaac Asimov	ethnic group	Jewish people
Irène Joliot-Curie	spouse	Frédéric Joliot-Curie
J. J. Abrams	occupation	television actor
Brazil	member of	United Nations
John Ruskin	occupation	poet
India	diplomatic relation	United Arab Emirates
Julian Lennon	sibling	Sean Lennon
Mel Brooks	country of citizenship	United States of America
Kiribati	diplomatic relation	Taiwan
Nicole Scherzinger	instrument	piano
Liberia	member of	Universal Postal Union
Joan Jett	occupation	vocalist
Russia	diplomatic relation	Iceland
Cambodia	diplomatic relation	Australia
Elvis Presley	occupation	actor
Keren Ann	instrument	guitar
Brazil	diplomatic relation	Australia
Russia	diplomatic relation	Latvia
Guyana	member of	Commonwealth of Nations
Christopher Lee	occupation	stage actor
Fredric Jameson	educated at	Yale University
Franz Kafka	genre	short story
Kyrgyzstan	diplomatic relation	Germany
Armenia	member of	Council of Europe
Jan Hammer	instrument	piano
Kelly Rowland	record label	Columbia Records
Regina Spektor	instrument	voice
Mýa	occupation	singer
Moby	instrument	piano
John William Strutt, 3rd Baron Rayleigh	member of	National Academy of Sciences
Carl Sagan	place of birth	Brooklyn
John von Neumann	field of work	mathematics
Dmitri Shostakovich	occupation	university teacher
Germany	diplomatic relation	Algeria
Malaysia	diplomatic relation	Jordan
Ivan Urgant	occupation	radio personality
Sheryl Crow	occupation	actor
Equatorial Guinea	diplomatic relation	People's Republic of China
Felipe Colombo	occupation	television actor
New Zealand	continent	Oceania
Saudi Arabia	member of	United Nations
Israel	member of	International Bank for Reconstruction and Development
Marshall Islands	member of	Interpol
Peter Lorre	languages spoken, written, or signed	German
Gene Simmons	genre	heavy metal
Darius Milhaud	occupation	conductor
Amy Lee	country of citizenship	United States of America
Jan Rubes	occupation	television presenter
South Africa	diplomatic relation	Italy
Julian Barnes	influenced by	Saul Bellow
John Frederick William Herschel	member of	Hungarian Academy of Sciences;
Telly Savalas	occupation	film actor
Doc Watson	occupation	singer
Peggy Lee	religion	Lutheranism
Liza Minnelli	languages spoken, written, or signed	English
Hungary	diplomatic relation	Japan
Taylor Momsen	country of citizenship	United States of America
Billy Preston	record label	A&M Records
Roger Waters	instrument	voice
Zimbabwe	member of	International Centre for Settlement of Investment Disputes
Thomas Anders	record label	Polydor Records
Gustavo Cerati	country of citizenship	Argentina
James Franco	occupation	television actor
Idina Menzel	field of work	musical composition
Paul McCartney	instrument	mandolin
Finland	member of	Council of Europe
Felix Klein	member of	Russian Academy of Sciences
György Lukács	place of birth	Budapest
Carlos Fuentes	member of	American Academy of Arts and Sciences
Marcel Proust	country of citizenship	France
Henry Wadsworth Longfellow	influenced by	Dante Alighieri
Selena Gomez	occupation	singer
Nicki Minaj	occupation	entrepreneur
Eswatini	member of	Multilateral Investment Guarantee Agency;
Iceland	member of	International Finance Corporation;
Lenny Kravitz	country of citizenship	United States of America
Maxim Gorki	ethnic group	Russians
Dee Dee Bridgewater	languages spoken, written, or signed	English
Rob Zombie	religion	atheism
Peter Debye	cause of death	myocardial infarction
Konrad Lorenz	member of	Royal Society
Bangladesh	diplomatic relation	Namibia
Shannon Leto	occupation	record producer
People's Republic of China	diplomatic relation	South Africa
Art Garfunkel	record label	Columbia Records
Robin Williams	languages spoken, written, or signed	English
Israel	diplomatic relation	Azerbaijan
Ernst Chladni	occupation	musician
James Clerk Maxwell	member of	Royal Society
Jan Hammer	country of citizenship	Czech Republic
Stephen Hawking	member of	Royal Society
Patrice Chéreau	member of	Bavarian Academy of Fine Arts
Joseph E. Stiglitz	occupation	professor
Thailand	diplomatic relation	India
Joseph E. Stiglitz	occupation	scientist
Ralf Dahrendorf	member of	Russian Academy of Sciences
Russell Brand	occupation	autobiographer
Richard Francis Burton	occupation	writer
Azerbaijan	diplomatic relation	People's Republic of China
Israel	diplomatic relation	Australia
Greece	diplomatic relation	Russia
Yasmina Reza	occupation	writer
Georgia	diplomatic relation	United Kingdom
Turkmenistan	diplomatic relation	India
Lesotho	member of	African Union
Mark Twain	languages spoken, written, or signed	German
Cliff Richard	occupation	guitarist
Colombia	member of	Organisation for the Prohibition of Chemical Weapons
Uruguay	diplomatic relation	Chile
Spain	member of	Visa Waiver Program
Senegal	member of	African Union
Count Basie	record label	Mercury Records
Alexander von Humboldt	occupation	scientist
Theodore Roosevelt	occupation	historian
Vanessa Williams	genre	rhythm and blues
Randy Jackson	sibling	La Toya Jackson
Dennis Gabor	occupation	engineer
Arnold Schwarzenegger	occupation	entrepreneur
Grenada	diplomatic relation	People's Republic of China
Sofia Kovalevskaya	occupation	physicist
Greece	diplomatic relation	United States of America
Rodion Shchedrin	genre	symphony
CeeLo Green	occupation	voice actor
Nikolai Gogol	place of burial	Novodevichy Cemetery
Hayley Williams	religion	Christianity
Enrique Iglesias	genre	pop rock
Mary Shelley	occupation	poet
Taiwan	diplomatic relation	Bahamas
Egypt	member of	International Centre for Settlement of Investment Disputes
Kinky Friedman	country of citizenship	United States of America
Tuvalu	continent	Oceania
Lenny Kravitz	instrument	voice
Vladimir Putin	languages spoken, written, or signed	Swedish
Clarence "Gatemouth" Brown	time period	20th century
Jan Josef Liefers	occupation	stage actor
Bruce Willis	country of citizenship	United States of America
Armenia	member of	Interpol
Ani Lorak	occupation	poet
Vatican City	member of	Organisation for the Prohibition of Chemical Weapons
Taiwan	diplomatic relation	Hong Kong
Alexander von Humboldt	member of	Royal Swedish Academy of Sciences;
Mick Ronson	place of death	London
Tonga	member of	Commonwealth of Nations
Denmark	diplomatic relation	Taiwan
Sergey Mikhalkov	occupation	science fiction writer
Goldie Hawn	religion	Judaism
Robert Musil	influenced by	Ernst Mach
Henry Louis Le Châtelier	place of birth	Paris
Guinea-Bissau	member of	Group on Earth Observations
Theodosius Dobzhansky	occupation	naturalist
Wole Soyinka	languages spoken, written, or signed	English
Missy Elliott	ethnic group	African Americans
Norman Wisdom	occupation	stage actor
Barry Gibb	genre	psychedelic rock
Charles Aznavour	languages spoken, written, or signed	French
John Cale	genre	experimental rock
Miguel de Unamuno	occupation	philosopher
Nicki Minaj	genre	pop music
"Weird Al" Yankovic	occupation	singer-songwriter
Ryan Tedder	occupation	singer
Xavier Cugat	occupation	composer
Dave Mustaine	record label	Capitol Records
Yoram Kaniuk	cause of death	cancer
Alla Pugacheva	genre	pop rock
Indonesia	diplomatic relation	State of Palestine
Aaliyah	record label	Jive
Arthur Schopenhauer	influenced by	John Locke
Pakistan	diplomatic relation	Norway
Russia	diplomatic relation	Fiji
Uzeyir Hajibeyov	occupation	playwright
Uganda	diplomatic relation	Israel
John Bardeen	member of	National Academy of Sciences
Romania	member of	Treaty on Open Skies;
Athanasius Kircher	religion	Catholic Church
Alfred Schnittke	genre	symphony
Allan Sherman	ethnic group	American Jews
Kiely Williams	occupation	singer-songwriter
Maria Callas	residence	New York City
Ani Lorak	country of citizenship	Ukraine
Kiribati	member of	UNESCO
James Franco	educated at	Yale University
Paris Hilton	genre	pop music
Yemen	member of	International Finance Corporation;
Ashanti	instrument	piano
Lauryn Hill	occupation	guitarist
Sarah Brightman	occupation	opera singer
Carl Djerassi	religion	atheism
Friedrich Schlegel	occupation	translator
Valeriya Novodvorskaya	occupation	translator
John Stuart Mill	member of	Hungarian Academy of Sciences;
Tanzania	member of	International Finance Corporation;
Alberto Manguel	occupation	literary critic
Mikhail Lermontov	occupation	translator
Kingdom of the Netherlands	member of	Missile Technology Control Regime
Mort Shuman	country of citizenship	United States of America
Guatemala	member of	World Trade Organization
Gabon	member of	United Nations
Iran	diplomatic relation	Iraq
Nigeria	part of	West Africa
Lionel Richie	instrument	saxophone
David Lindley	record label	Columbia Records
Charles Mingus Jr.	record label	Columbia Records
Korney Chukovsky	occupation	children's writer
Mikhail Vassilyevich Lomonosov	occupation	inventor
Fazil Iskander	genre	satire
Panama	diplomatic relation	Taiwan
George Martin	field of work	musical composition
Chris Brown	occupation	rapper
György Lukács	occupation	university teacher
Charles Rosen	influenced by	Arnold Schoenberg
Donny Osmond	occupation	songwriter
France	diplomatic relation	Holy See
H. P. Lovecraft	languages spoken, written, or signed	English
Mika	occupation	musician
Paula Abdul	country of citizenship	United States of America
Botswana	diplomatic relation	Namibia
Lionel Richie	genre	soul music
Duke Ellington	occupation	musician
Jacobus Henricus van 't Hoff	member of	Royal Society
United Kingdom	diplomatic relation	Saudi Arabia
J. M. Coetzee	occupation	university teacher
Azerbaijan	member of	UNESCO
Tajikistan	diplomatic relation	Russia
Jim Morrison	instrument	keyboard instrument
Belgium	member of	International Telecommunication Union
Valentin Kataev	member of political party	Communist Party of the Soviet Union
Chris Cornell	religion	Catholicism
Dennis Gabor	occupation	physicist
Bernard-Henri Lévy	occupation	writer
Iceland	member of	Multilateral Investment Guarantee Agency;
Suriname	member of	Organisation of Islamic Cooperation
Carrie Fisher	occupation	novelist
Kid Rock	country of citizenship	United States of America
Darius Milhaud	occupation	pianist
John Lennon	genre	psychedelic rock
Lucy Liu	educated at	New York University
South Sudan	member of	International Development Association
Jon Bon Jovi	record label	Island Records
Hungary	diplomatic relation	Azerbaijan
Arthur Miller	member of	American Academy of Arts and Letters
Syria	member of	Arab Fund for Economic and Social Development
John de Lancie	educated at	Juilliard School
Jordin Sparks	unmarried partner	Jason Derulo
State of Palestine	diplomatic relation	Denmark
Arthur Conan Doyle	occupation	novelist
Pavel Jozef Šafárik	religion	Lutheranism
Kazakhstan	diplomatic relation	Ukraine
Nicki Minaj	occupation	singer-songwriter
Kate Bush	occupation	singer
Canada	diplomatic relation	Morocco
Dave Mustaine	genre	hard rock
Gambia	member of	International Bank for Reconstruction and Development
Costa Rica	member of	Interpol
Jaroslav Vrchlický	occupation	librettist
RuPaul	occupation	producer
Georgia	diplomatic relation	North Korea
Arthur Schopenhauer	occupation	university teacher
Burkina Faso	diplomatic relation	Georgia
United Kingdom	diplomatic relation	Australia
Anthony Kiedis	instrument	guitar
Australia	diplomatic relation	India
Czech Republic	member of	European Southern Observatory
J. M. Coetzee	member of	Royal Society of Literature
Sidney Poitier	occupation	film director
Ghana	diplomatic relation	Togo
Bangladesh	diplomatic relation	Mauritius
Al Jolson	place of death	San Francisco
Heinrich Wilhelm Olbers	member of	German Academy of Sciences Leopoldina
Mauritania	member of	International Development Association
Amanda Palmer	languages spoken, written, or signed	English
Katy Perry	genre	pop music
Wallace Shawn	member of	American Academy of Arts and Letters
Gene Simmons	occupation	blogger
Vincent Gallo	occupation	film director
Lisa Loeb	instrument	voice
Kelly Clarkson	occupation	film actor
Robert Louis Stevenson	influenced by	Guy de Maupassant
Bulgaria	member of	Organisation internationale de la Francophonie
Greece	member of	Universal Postal Union
Tim Rose	occupation	singer-songwriter
Paul Langevin	occupation	chemist
Massimo Bontempelli	occupation	translator
Algeria	member of	African Development Bank
Adriano Celentano	occupation	film editor
William Herschel	country of citizenship	Great Britain
Vanessa Williams	occupation	film actor
Yukio Mishima	occupation	poet
Robert Schumann	genre	symphony
Oprah Winfrey	occupation	television actor
Augustin-Louis Cauchy	field of work	mathematics
Olivier Messiaen	member of	American Academy of Arts and Sciences
South Sudan	diplomatic relation	India
Luciano Berio	occupation	composer
Nahum Sokolow	country of citizenship	Russian Empire
Willie Nelson	occupation	television producer
Christoph Wilhelm Hufeland	occupation	university teacher
Ľudovít Štúr	occupation	historian
Bobby Brown	medical condition	bipolar disorder
Kiribati	diplomatic relation	People's Republic of China
Yemen	member of	Organisation of Islamic Cooperation
Cameroon	member of	Multilateral Investment Guarantee Agency;
Papua New Guinea	diplomatic relation	United Kingdom
Buckethead	instrument	mandolin
Paul McCartney	occupation	film score composer
Italo Calvino	occupation	journalist
Gabriel Marcel	influenced by	Henri Bergson
New Zealand	diplomatic relation	Malaysia
Bret Michaels	occupation	film actor
Afghanistan	member of	International Centre for Settlement of Investment Disputes
Germany	diplomatic relation	Kuwait
Lena Meyer-Landrut	genre	indie pop
Julie Delpy	residence	New York City
Hayley Kiyoko	country of citizenship	United States of America
Lucy Liu	occupation	stage actor
Philippines	diplomatic relation	Sri Lanka
Corbin Bleu	occupation	stage actor
Simon Newcomb	languages spoken, written, or signed	English
Walter Scott	member of	Royal Society of Edinburgh
Korney Chukovsky	country of citizenship	Russian Empire
Emilie Autumn	occupation	writer
Erika Mann	country of citizenship	Germany
Nyusha	genre	pop music
David Mamet	country of citizenship	United States of America
Shakira	instrument	harmonica
David Lynch	occupation	film producer
Moldova	continent	Europe
Syria	diplomatic relation	United Arab Emirates
Guyana	diplomatic relation	Barbados
Hungary	official language	Hungarian
Guyana	diplomatic relation	Mexico
Korney Chukovsky	country of citizenship	Soviet Union
People's Republic of China	diplomatic relation	Liberia
Tony Visconti	genre	hard rock
Nikolay Basov	occupation	politician
Rainer Werner Fassbinder	occupation	actor
Taiwan	diplomatic relation	Italy
Charles Bukowski	occupation	poet
Hungary	diplomatic relation	Taiwan
Ruslana	record label	EMI
Gore Vidal	occupation	playwright
Paul Krugman	member of	American Academy of Arts and Sciences
Romania	diplomatic relation	France
Bahamas	member of	Group on Earth Observations
Rita Levi-Montalcini	residence	United States of America
Richard Sennett	member of	American Academy of Arts and Sciences
Alexander Emanuel Agassiz	member of	Royal Society
Rainer Werner Fassbinder	occupation	television actor
Moldova	diplomatic relation	Denmark
Bob Dylan	occupation	composer
Ronny Cox	occupation	film actor
Lesotho	member of	UNESCO
Kurt Vonnegut	genre	satire
Germany	diplomatic relation	United Arab Emirates
Janel Parrish	residence	Los Angeles
Iraq	continent	Asia
James Joyce	occupation	prose
Sweden	member of	Australia Group
Henri Becquerel	country of citizenship	France
Bella Thorne	occupation	film actor
J. Rodolfo Wilcock	languages spoken, written, or signed	Italian
Romain Gary	occupation	diplomat
Turkey	diplomatic relation	Malaysia
Hayley Williams	instrument	guitar
Serbia	diplomatic relation	Ghana
Joe Jackson	occupation	actor
John Denver	record label	Mercury Records
Mark Salling	occupation	film actor
Hungary	diplomatic relation	Honduras
Elvis Presley	genre	rock music
Turkey	diplomatic relation	North Macedonia
Eric Burdon	occupation	songwriter
Jim Messina	record label	Columbia Records
Bertolt Brecht	religion	atheism
Poland	member of	Movement Coordination Centre Europe
Maya Angelou	occupation	film director
Gavriil Troyepolsky	occupation	prosaist
Elfriede Jelinek	occupation	author
John Locke	cause of death	myocardial infarction
Carly Simon	member of political party	Democratic Party
Russia	diplomatic relation	Nepal
Netherlands	country	Kingdom of the Netherlands
Alberto Manguel	occupation	journalist
Cambodia	continent	Asia
Central African Republic	diplomatic relation	Democratic Republic of the Congo
Woody Allen	occupation	film director
Tamer Hosny	occupation	writer
New Zealand	member of	UNESCO
Gustavo Cerati	occupation	singer
Jaan Kaplinski	occupation	university teacher
Ireland	diplomatic relation	Australia
Arthur C. Clarke	occupation	screenwriter
Joe Jonas	occupation	actor
Sweden	member of	International Centre for Settlement of Investment Disputes
Ecuador	diplomatic relation	Iran
George Martin	occupation	record producer
Yemen	member of	African Union – United Nations Hybrid Operation in Darfur
Algeria	member of	United Nations
Billy Connolly	occupation	actor
Elizabeth Bishop	field of work	essay
Nick Cannon	record label	Jive
Eswatini	member of	World Trade Organization
North Macedonia	member of	International Finance Corporation;
Carl Sagan	field of work	astronomer
Jordan	member of	Arab Monetary Fund;
Saudi Arabia	diplomatic relation	Kyrgyzstan
James Franco	occupation	writer
Samuel Beckett	occupation	translator
Australia	diplomatic relation	Hungary
People's Republic of China	diplomatic relation	Malawi
Alla Pugacheva	occupation	television presenter
Robert Frost	influenced by	William Butler Yeats
India	diplomatic relation	Jamaica
Denmark	continent	Europe
C. S. Lewis	occupation	linguist
Raymond Aron	languages spoken, written, or signed	French
Lance Bass	occupation	actor
Dmitri Kabalevsky	occupation	politician
Fiji	official language	English
Vince Vaughn	languages spoken, written, or signed	English
Turkey	diplomatic relation	Argentina
Equatorial Guinea	member of	African Development Bank
Bosnia and Herzegovina	diplomatic relation	Croatia
Nikolay Semyonov	occupation	physicist
John Travolta	occupation	writer
Peter Tork	occupation	film producer
East Timor	member of	International Telecommunication Union
William Thomson, 1st Baron Kelvin	occupation	politician
Thomas Jefferson	occupation	writer
Bhutan	diplomatic relation	People's Republic of China
Leo Tolstoy	employer	Saint Petersburg Academy of Sciences
Meaghan Jette Martin	country of citizenship	United States of America
Julieta Venegas	languages spoken, written, or signed	Spanish
Frédéric Joliot-Curie	member of	French Academy of Sciences
Little Richard	instrument	voice
Marc Connelly	member of	American Academy of Arts and Letters
United States of America	diplomatic relation	Afghanistan
Connie Francis	medical condition	bipolar disorder
Paul Reiser	occupation	screenwriter
Bob Mould	occupation	disc jockey
Max Born	employer	Humboldt University of Berlin
Joss Whedon	occupation	screenwriter
Ariana Grande	occupation	dancer
Hugh Laurie	occupation	film actor
Pierre-Joseph Proudhon	field of work	philosophy
Tatyana Tolstaya	occupation	journalist
Ethiopia	member of	International Bank for Reconstruction and Development
Vladimir Mayakovsky	occupation	poet
Deryck Whibley	residence	Los Angeles
Albert Einstein	occupation	university teacher
GoonRock	instrument	piano
George Martin	genre	classical music
Billie Holiday	genre	blues
Jodie Foster	languages spoken, written, or signed	French
Christina Aguilera	occupation	singer
T-Bone Walker	genre	blues
Henry Rollins	religion	atheism
Lauryn Hill	occupation	film actor
Lisa Loeb	occupation	singer-songwriter
Gene Autry	occupation	actor
Gene Kelly	place of death	Beverly Hills
Adam Levine	occupation	musician
Ike Turner	occupation	guitarist
Mika	instrument	voice
Johnny Cash	occupation	autobiographer
Qatar	diplomatic relation	Israel
Mauritania	member of	World Trade Organization
Joan Jett	occupation	television actor
Gambia	member of	African Union – United Nations Hybrid Operation in Darfur
Joseph Brodsky	member of	Bavarian Academy of Fine Arts
Bangladesh	diplomatic relation	Syria
Albert Camus	occupation	writer
Sarah Brightman	occupation	actor
Benedetto Croce	member of	Royal Swedish Academy of Sciences;
Rob Reiner	occupation	film producer
Paul McCartney	occupation	guitarist
Guinea-Bissau	member of	UNESCO
Seth MacFarlane	occupation	film actor
Anton Chekhov	influenced by	Honoré de Balzac
Tatyana Tolstaya	languages spoken, written, or signed	Russian
Aimee Mann	instrument	guitar
Steve Martin	occupation	film producer
John von Neumann	languages spoken, written, or signed	Latin
Turkey	diplomatic relation	Ethiopia
Azerbaijan	member of	Organisation of Islamic Cooperation
India	diplomatic relation	Israel
Moby	instrument	bass guitar
Ignaz Moscheles	occupation	musicologist
Cambodia	member of	World Trade Organization
Egypt	diplomatic relation	Israel
Natalie Cole	occupation	voice actor
Peter Kropotkin	occupation	writer
Lou Reed	genre	experimental rock
Billy Bob Thornton	occupation	television actor
Hayley Kiyoko	occupation	film actor
Keith Richards	languages spoken, written, or signed	English
Aimee Mann	occupation	musician
Guinea-Bissau	member of	Multilateral Investment Guarantee Agency;
Henri Bergson	member of	American Academy of Arts and Sciences
Kwame Anthony Appiah	occupation	journalist
Peter Tork	place of birth	Washington, D.C.
Taylor Swift	occupation	guitarist
Bret Michaels	instrument	voice
Linda Ronstadt	occupation	composer
Slavoj Žižek	occupation	sociologist
M. Pokora	unmarried partner	Christina Milian
RZA	occupation	record producer
Penny Marshall	occupation	writer
Niger	diplomatic relation	Taiwan
David Bowie	genre	soul music
AJ Michalka	genre	pop music
Germany	diplomatic relation	India
Chad	continent	Africa
Sara Bareilles	record label	Sony Music
Telly Savalas	member of political party	Democratic Party
Ashanti	occupation	model
Leonardo da Vinci	occupation	inventor
Mark Linkous	occupation	keyboardist
Andrey Korotayev	occupation	political scientist
Harry Chapin	instrument	piano
Ayọ	record label	Interscope Records
John von Neumann	member of	American Academy of Arts and Sciences
Marguerite Duras	occupation	screenwriter
Carrie Underwood	occupation	composer
Josiah Willard Gibbs	member of	Göttingen Academy of Sciences;
Leonardo da Vinci	occupation	painter
Mark Ronson	languages spoken, written, or signed	English
Paul Anka	instrument	guitar
Chinghiz Aitmatov	occupation	science fiction writer
Thomas Mann	occupation	diarist
Israel	diplomatic relation	Finland
Paul Langevin	place of birth	Paris
Veniamin Smekhov	occupation	screenwriter
Tamara Bunke	instrument	guitar
Priscilla Presley	occupation	film actor
Yemen	diplomatic relation	United Kingdom
Pyotr Ilyich Tchaikovsky	occupation	music pedagogue
Mel Brooks	occupation	television producer
Mauritius	diplomatic relation	Malaysia
Erika Mann	languages spoken, written, or signed	German
Béla Bartók	member of	Hungarian Academy of Sciences;
Luxembourg	member of	World Trade Organization
Julie Delpy	occupation	composer
Jean-Paul Sartre	occupation	essayist
Montesquieu	occupation	philosopher
Bulat Okudzhava	religion	Islam
South Korea	diplomatic relation	Philippines
Akiko Yano	country of citizenship	Japan
Karel Jaromír Erben	movement	Romanticism
Richard Marx	occupation	musician
Uganda	member of	"African, Caribbean and Pacific Group of States"
Amr Diab	occupation	film actor
Russell Brand	occupation	television presenter
Zoolander	cast member	Natalie Portman
Greece	diplomatic relation	Lithuania
Émile Zola	country of citizenship	France
Bangladesh	diplomatic relation	Botswana
La Toya Jackson	sibling	Randy Jackson
Ilya Ilf	occupation	journalist
Fredric Jameson	country of citizenship	United States of America
Michael Nesmith	genre	country music
Hungary	diplomatic relation	United States of America
Afghanistan	continent	Asia
Noam Chomsky	occupation	philosopher
Italy	diplomatic relation	Belarus
Thomas Paine	ethnic group	English people
Erwin Raisz	languages spoken, written, or signed	English
Gottfried Wilhelm Leibniz	languages spoken, written, or signed	English
Joseph Brodsky	occupation	essayist
Jacobus Henricus van 't Hoff	member of	Göttingen Academy of Sciences;
Arthur Conan Doyle	occupation	physician
Ice Cube	place of birth	Los Angeles
Guatemala	diplomatic relation	Taiwan
Zhores Alfyorov	member of	Accademia Nazionale delle Scienze detta dei XL
Melanie C	genre	pop rock
Dmitry Glukhovsky	influenced by	Julio Cortázar
Jamaica	diplomatic relation	Canada
Rudolf Virchow	member of	Royal Society
Montenegro	member of	United Nations
Dante Alighieri	occupation	poet
Rabindranath Tagore	occupation	artist
Billy Preston	influenced by	Ray Charles
Hu Shih	member of	German Academy of Sciences at Berlin
Luciano Berio	occupation	conductor
Bo Burnham	occupation	singer-songwriter
RCA Records	genre	country music
Keith Richards	occupation	singer-songwriter
David Mamet	employer	Columbia University
will.i.am	occupation	disc jockey
Joan Baez	genre	country music
Ted Nugent	place of birth	Detroit
Denis Johnson	occupation	science fiction writer
J. R. R. Tolkien	influenced by	G. K. Chesterton
Aaron Copland	occupation	musicologist
Mike Shinoda	instrument	voice
Herman Melville	residence	New York City
Lithuania	diplomatic relation	Taiwan
Jon Bon Jovi	occupation	pianist
Dr. Dre	instrument	voice
Toni Braxton	occupation	film actor
Ivory Coast	member of	Universal Postal Union
India	diplomatic relation	Egypt
Herman Francis Mark	country of citizenship	United States of America
Taylor Swift	occupation	lyricist
50 Cent	occupation	producer
Singapore	member of	Universal Postal Union
Brendon Urie	instrument	voice
Dolly Parton	occupation	recording artist
Yegor Letov	occupation	singer
Hans Mayer	country of citizenship	German Democratic Republic
Andrew Ridgeley	instrument	piano
Susan Sontag	member of	American Academy of Arts and Sciences
Saint Lucia	diplomatic relation	United States of America
Harold Bloom	place of birth	New York City
Doc Watson	occupation	guitarist
Bangladesh	diplomatic relation	Nigeria
Denmark	member of	International Telecommunication Union
Philippines	diplomatic relation	South Sudan
Germany	diplomatic relation	Venezuela
Robert De Niro	country of citizenship	United States of America
India	diplomatic relation	Madagascar
Liechtenstein	diplomatic relation	Austria
Argentina	diplomatic relation	South Africa
Isaac Asimov	religion	atheism
Giovanni Schiaparelli	member of	Accademia Nazionale delle Scienze detta dei XL
Søren Kierkegaard	occupation	poet
Klaus Mann	occupation	journalist
Augusto Righi	member of	Russian Academy of Sciences
Mýa	instrument	voice
Peru	diplomatic relation	Uruguay
Toni Braxton	ethnic group	African Americans
Andriy Danylko	occupation	presenter
David Mamet	member of	American Academy of Arts and Letters
Equatorial Guinea	member of	Universal Postal Union
Yoram Kaniuk	country of citizenship	Israel
South Africa	member of	Southern African Development Community
Iran	diplomatic relation	Australia
Connie Francis	member of political party	Republican Party
Uruguay	diplomatic relation	Hungary
Andy Griffith	country of citizenship	United States of America
Steven Van Zandt	occupation	mandolinist
Georgia	diplomatic relation	Gabon
Theodosius Dobzhansky	member of	German Academy of Sciences Leopoldina
Larry David	occupation	voice actor
Kylie Minogue	record label	Parlophone
Xavier Cugat	country of citizenship	Spain
Mick Wingert	languages spoken, written, or signed	English
Natalie Cole	occupation	jazz musician
Malta	member of	European Union
Lou Reed	occupation	poet
North Macedonia	member of	UNESCO
Sofia Kovalevskaya	educated at	Humboldt University of Berlin
Chinghiz Aitmatov	occupation	screenwriter
Japan	member of	Nuclear Suppliers Group
Frank Zappa	occupation	jazz musician
Jacobus Henricus van 't Hoff	occupation	chemist
Bernard-Henri Lévy	occupation	film producer
Samuel Johnson	place of death	London
Jordan	member of	Arab Bank for Economic Development in Africa;
People's Republic of China	member of	UNESCO
Charlotte Gainsbourg	languages spoken, written, or signed	English
Bobby Brown	genre	dance-pop
Charles Wheatstone	residence	United Kingdom of Great Britain and Ireland
Saudi Arabia	member of	World Trade Organization
United Kingdom	diplomatic relation	Chile
Benedetto Croce	member of	American Academy of Arts and Sciences
Slovenia	diplomatic relation	Kosovo
Benjamin Britten	member of	Bavarian Academy of Fine Arts
Arthur Conan Doyle	occupation	children's writer
Taiwan	diplomatic relation	Nepal
Ferdinand von Richthofen	country of citizenship	Germany
Friedrich Schiller	cause of death	tuberculosis
Bo Burnham	country of citizenship	United States of America
Gilles Deleuze	influenced by	Jorge Luis Borges
Shakira	residence	Los Angeles
Jean-Baptiste Dumas	occupation	politician
John Cale	instrument	piano
Petula Clark	occupation	recording artist
Mick Jagger	instrument	piano
Konstantin Fedin	languages spoken, written, or signed	Russian
Bob Hope	occupation	television actor
Waylon Jennings	instrument	voice
John Mayer	genre	rock music
Montenegro	diplomatic relation	Slovenia
RCA Records	genre	rhythm and blues
Jared Leto	instrument	piano
Lea Michele	occupation	singer-songwriter
Euclides da Cunha	occupation	military personnel
Jacobus Henricus van 't Hoff	member of	Hungarian Academy of Sciences;
State of Palestine	diplomatic relation	Egypt
Gotthold Ephraim Lessing	occupation	poet
Soulja Boy	genre	pop music
Lance Bass	occupation	film actor
Cliff Richard	occupation	entrepreneur
Panama	diplomatic relation	Uruguay
Timbaland	instrument	voice
Wassily Kandinsky	country of citizenship	Russian Empire
Adam Sandler	place of birth	Brooklyn
Antoine César Becquerel	country of citizenship	France
Italy	diplomatic relation	People's Republic of China
Ernst Curtius	employer	University of Göttingen
Benin	diplomatic relation	Taiwan
Rob Zombie	occupation	guitarist
Mika	record label	Republic Records
Robert Graves	occupation	novelist
James Blunt	genre	pop rock
Angola	diplomatic relation	Hungary
Afghanistan	member of	Interpol
Kingdom of the Netherlands	member of	Australia Group
Slovenia	diplomatic relation	Australia
Morocco	diplomatic relation	Libya
"Weird Al" Yankovic	instrument	synthesizer
Ben Moody	occupation	actor
Milva	genre	opera
Mike Myers	country of citizenship	Canada
Konrad Lorenz	member of	National Academy of Sciences
Monaco	diplomatic relation	Germany
David Bowie	genre	new wave
Tina Turner	occupation	television actor
Harold Pinter	occupation	theater director
Trinidad and Tobago	diplomatic relation	Australia
Federated States of Micronesia	diplomatic relation	Australia
Renato Carosone	instrument	accordion
Jolin Tsai	occupation	entrepreneur
Donny Hathaway	genre	soul music
Thomas Paine	occupation	journalist
Kris Kristofferson	occupation	film actor
Massimo Bontempelli	occupation	novelist
Guy de Maupassant	movement	literary realism
Sudan	member of	Universal Postal Union
South Africa	diplomatic relation	Germany
Chris Martin	record label	Parlophone
Tunisia	diplomatic relation	Morocco
Uzbekistan	member of	Organisation for the Prohibition of Chemical Weapons
Taiwan	diplomatic relation	Niger
Joe Cocker	occupation	actor
John Frederick William Herschel	member of	German Academy of Sciences Leopoldina
Denmark	diplomatic relation	Bhutan
Gilles Deleuze	languages spoken, written, or signed	French
Peter Kropotkin	place of burial	Novodevichy Cemetery
Yemen	diplomatic relation	Malaysia
Holy Roman Empire	official language	Latin
George Soros	member of political party	Democratic Party
Glen Campbell	instrument	banjo
Yemen	diplomatic relation	Pakistan
Daniel Johnston	record label	Atlantic Records
Timbaland	languages spoken, written, or signed	English
Fred Hoyle	field of work	astronomy
Boris Vian	occupation	singer-songwriter
Common	record label	Geffen Records
Charles Dickens	country of citizenship	United Kingdom
Elizabeth Bishop	languages spoken, written, or signed	English
Richard Dawkins	occupation	author
Diana Ross	occupation	singer
Friedrich Nietzsche	field of work	poetry
Connie Smith	record label	RCA Records
Joseph Liouville	occupation	mathematician
Jonathan Winters	medical condition	bipolar disorder
Mos Def	occupation	record producer
Croatia	member of	Movement Coordination Centre Europe
Denis Johnson	member of	American Academy of Arts and Letters
Jules Verne	occupation	poet
Charlton Heston	occupation	voice actor
Romania	diplomatic relation	Germany
Ted Nugent	occupation	composer
Erich Kästner	educated at	Leipzig University
West Germany	diplomatic relation	German Democratic Republic
J. K. Rowling	influenced by	C. S. Lewis
Richard Wagner	place of birth	Leipzig
Mylène Farmer	occupation	poet
Isaac Asimov	occupation	prosaist
Lion Feuchtwanger	country of citizenship	Weimar Republic
Paris Hilton	languages spoken, written, or signed	English
Gabon	member of	Multilateral Investment Guarantee Agency;
Eduard Suess	member of	Royal Prussian Academy of Sciences
Vladimir Vysotsky	occupation	lyricist
Heinrich Wilhelm Gottfried von Waldeyer-Hartz	country of citizenship	German Empire
Nicholas Marr	occupation	archaeologist
Gordon Parks	occupation	actor
Victor Hugo	occupation	novelist
United Kingdom	diplomatic relation	Kenya
Marshall Islands	diplomatic relation	United States of America
Edgar Allan Poe	occupation	author
Denmark	diplomatic relation	People's Republic of China
Christina Aguilera	occupation	voice actor
Switzerland	diplomatic relation	Indonesia
Anton Chekhov	influenced by	Nikolai Gogol
Kiribati	diplomatic relation	Spain
Joan Baez	occupation	singer
Norway	member of	Organization for Security and Co-operation in Europe
Herbie Hancock	occupation	pianist
Renato Carosone	genre	blues
Tina Turner	ethnic group	African Americans
Syria	diplomatic relation	European Union
Billy Crystal	occupation	television actor
Zambia	member of	Multilateral Investment Guarantee Agency;
Bhutan	continent	Asia
Ayn Rand	occupation	science fiction writer
Finland	member of	Missile Technology Control Regime
Venezuela	diplomatic relation	Canada
Mauritania	part of	West Africa
Argentina	diplomatic relation	Ireland
Vitamin C	field of work	musical composition
Roy Orbison	occupation	singer
David Foster	genre	contemporary R&B
Kingdom of the Netherlands	member of	World Trade Organization
Marvin Gaye	country of citizenship	United States of America
Sam Cooke	ethnic group	African Americans
Mikhail Vassilyevich Lomonosov	cause of death	pneumonia
Akon	religion	Islam
Kuwait	diplomatic relation	Germany
Cape Verde	diplomatic relation	Georgia
Georges-Louis Leclerc, Comte de Buffon	occupation	astronomer
The Compleat Beatles	cast member	George Martin
Angie Stone	field of work	musical composition
Comoros	member of	OHADA
Bryan Ferry	genre	new wave
Renaud	occupation	film actor
Rita Lee	occupation	singer
Henri Victor Regnault	member of	Royal Swedish Academy of Sciences;
Aaron Copland	genre	opera
Billy Preston	cause of death	renal insufficiency
Nas	occupation	recording artist
Adam Lambert	instrument	voice
Karl Popper	residence	Vienna
San Marino	member of	International Centre for Settlement of Investment Disputes
Brazil	member of	Missile Technology Control Regime
Tanzania	diplomatic relation	Taiwan
Mario Vargas Llosa	country of citizenship	Spain
Barbados	member of	International Finance Corporation;
Trinidad and Tobago	diplomatic relation	Chile
A. R. Rahman	religion	Islam
Galileo Galilei	occupation	mathematician
Czech Republic	member of	Organisation for Economic Cooperation and Development
Spain	member of	Schengen Area
Billy Preston	occupation	film actor
São Tomé and Príncipe	member of	Organisation internationale de la Francophonie
Italy	diplomatic relation	Vietnam
Russia	diplomatic relation	Zambia
Peter Gay	movement	atheism
Julie Delpy	occupation	film director
Damon Albarn	genre	alternative rock
Drake	genre	dance music
Lithuania	diplomatic relation	Malaysia
Japan	member of	International Development Association
Buffy Sainte-Marie	genre	country music
France	diplomatic relation	Vanuatu
Jay Chou	instrument	bass guitar
Hungary	diplomatic relation	North Macedonia
Somalia	diplomatic relation	Kenya
Joni Mitchell	genre	folk rock
Tinashe	instrument	voice
New Zealand	diplomatic relation	Singapore
Peru	member of	United Nations
Libya	member of	Arab League
Chris Brown	occupation	composer
Andrey Vyshinsky	occupation	jurist
François Arago	member of	Royal Prussian Academy of Sciences
Julio Iglesias	languages spoken, written, or signed	German
Nepal	member of	Universal Postal Union
George Soros	country of citizenship	Hungary
Lana Del Rey	residence	Los Angeles
Myanmar	member of	International Telecommunication Union
Kazakhstan	diplomatic relation	Uzbekistan
Slovenia	diplomatic relation	Belarus
Peter Debye	member of	Royal Netherlands Academy of Arts and Sciences
Sarah Brightman	occupation	film actor
Belgium	member of	International Centre for Settlement of Investment Disputes
Sweden	diplomatic relation	Norway
Katharine McPhee	languages spoken, written, or signed	English
Jackie Jackson	ethnic group	African Americans
Denmark	diplomatic relation	European Union
Vietnam	diplomatic relation	Serbia
Anthony Burgess	occupation	children's writer
Leo Tolstoy	cause of death	pneumonia
South Sudan	diplomatic relation	Kenya
John Lennon	occupation	poet
Adam Sandler	residence	Los Angeles
Trinidad and Tobago	member of	Agency for the Prohibition of Nuclear Weapons in Latin America and the Caribbean
Denmark	diplomatic relation	Slovakia
Van McCoy	record label	Columbia Records
Marcellin Berthelot	member of	French Academy of Sciences
William H. Macy	occupation	television actor
Saul Bellow	influenced by	Thomas Mann
Peter Buck	occupation	mandolinist
Brunei	diplomatic relation	South Korea
Robin Gibb	instrument	voice
Steven Weinberg	member of	American Philosophical Society
Veniamin Smekhov	occupation	director
Fritz Haber	member of	Russian Academy of Sciences
Kiribati	member of	Universal Postal Union
Taiwan	diplomatic relation	Malawi
Croatia	diplomatic relation	Hungary
Jennifer Love Hewitt	record label	Atlantic Records
Japan	member of	Interpol
Malaysia	diplomatic relation	Cambodia
Robert Frost	employer	Harvard University
Arnold Schoenberg	cause of death	myocardial infarction
Russia	diplomatic relation	Portugal
Frédéric Chopin	occupation	pianist
Pakistan	diplomatic relation	Poland
Rudyard Kipling	member of	Royal Society of Literature
Donny Osmond	genre	rhythm and blues
Mauritius	member of	International Centre for Settlement of Investment Disputes
John de Lancie	occupation	film director
Boris Grebenshchikov	instrument	guitar
J. M. Coetzee	religion	atheism
Russia	diplomatic relation	Iraq
Phil Harris	occupation	singer
Benin	member of	Organisation of Islamic Cooperation
Leonhard Euler	field of work	mathematics
Pakistan	diplomatic relation	Maldives
Billy Preston	occupation	musician
Italy	member of	African Development Bank
Omar Sharif	cause of death	myocardial infarction
Per Olov Enquist	occupation	author
Lisa Lopes	residence	Atlanta
Randy Jackson	sibling	Rebbie Jackson
Nicholas Marr	occupation	linguist
June Carter Cash	instrument	harmonica
Malta	member of	Council of Europe
Kanye West	occupation	blogger
Kuwait	diplomatic relation	United States of America
Judy Garland	occupation	radio personality
India	diplomatic relation	Nigeria
Peter Kropotkin	occupation	zoologist
Shen Kuo	occupation	physicist
Ilya Oleynikov	occupation	presenter
Hayley Williams	occupation	singer
William S. Burroughs	genre	science fiction
Georgia	diplomatic relation	Vatican City
Gaspard de Prony	occupation	mathematician
John Legend	occupation	television actor
Jared Leto	country of citizenship	United States of America
T. S. Eliot	languages spoken, written, or signed	English
George Santayana	occupation	poet
Yvonne De Carlo	instrument	voice
Dave Mustaine	occupation	singer-songwriter
Deryck Whibley	record label	Island Records
Costa Rica	member of	International Bank for Reconstruction and Development
Gloria Trevi	occupation	actor
Ernst Curtius	occupation	anthropologist
Cameroon	official language	English
The Compleat Beatles	cast member	Donovan
Wallace Shawn	place of birth	New York City
Jean-Luc Godard	occupation	film editor
Britney Spears	country of citizenship	United States of America
Israel	diplomatic relation	South Korea
Jérôme Lalande	member of	Royal Prussian Academy of Sciences
Lenny Kravitz	occupation	multi-instrumentalist
Cuba	member of	Universal Postal Union
Mickey Rooney	occupation	screenwriter
Joyce Carol Oates	member of	American Academy of Arts and Letters
Cuba	part of	Hispanic America
Guatemala	continent	North America
Viggo Mortensen	religion	Lutheranism
Lena Horne	record label	Decca
Daniel Johnston	occupation	guitarist
Erich Kästner	country of citizenship	Weimar Republic
Simon Newcomb	member of	Accademia Nazionale delle Scienze detta dei XL
Jacob Grimm	occupation	linguist
Libya	diplomatic relation	Grenada
India	diplomatic relation	Mongolia
Libya	diplomatic relation	Montenegro
Kris Kristofferson	instrument	harmonica
Thomas Carlyle	occupation	teacher
Honduras	member of	International Bank for Reconstruction and Development
Adam Ant	record label	MCA Records
Alanis Morissette	occupation	producer
People's Republic of China	diplomatic relation	Bhutan
Kenneth Burke	occupation	university teacher
Eric Idle	occupation	screenwriter
Frank Zappa	occupation	voice actor
Belarus	diplomatic relation	Chile
Central African Republic	member of	African Development Bank
Carl Djerassi	occupation	scientist
Ted Nugent	genre	hard rock
People's Republic of China	diplomatic relation	Denmark
Denis Johnson	place of birth	Munich
Albert Lortzing	instrument	voice
Fredro Starr	record label	Def Jam Recordings
Clive Barker	occupation	playwright
Dido	occupation	composer
Nas	instrument	voice
Albert Camus	occupation	essayist
Johnny Cash	occupation	singer-songwriter
Bangladesh	diplomatic relation	Oman
Paul McCartney	genre	pop rock
Carly Simon	instrument	guitar
Jada Pinkett Smith	occupation	composer
Todd Rundgren	genre	progressive rock
Rihanna	record label	Def Jam Recordings
Herman Francis Mark	educated at	University of Vienna
Raymond Aron	educated at	University of Paris (1896-1968)
Kenneth Burke	languages spoken, written, or signed	English
Mary J. Blige	record label	Geffen Records
Beth Hart	instrument	piano
Kenneth Burke	occupation	music critic
Neil Patrick Harris	occupation	actor
Lena Meyer-Landrut	instrument	voice
Stacie Orrico	country of citizenship	United States of America
Lion Feuchtwanger	country of citizenship	German Empire
State of Palestine	diplomatic relation	Bangladesh
Australia	diplomatic relation	Kosovo
Hugh Laurie	occupation	musician
Jacobus Henricus van 't Hoff	educated at	University of Paris (1896-1968)
Croatia	diplomatic relation	Italy
Ferdinand von Richthofen	member of	National Academy of Sciences
Somalia	diplomatic relation	Italy
Robbie Robertson	record label	Warner Bros.
Georges-Louis Leclerc, Comte de Buffon	occupation	writer
Marvin Gaye	genre	pop music
Botswana	diplomatic relation	Australia
Kid Cudi	occupation	rapper
Greece	member of	Organisation for Economic Cooperation and Development
Andy Williams	country of citizenship	United States of America
Bret Michaels	occupation	composer
Bolivia	diplomatic relation	Cuba
